111111111111111111111
100000000010000000001
101101111010111011101
100100000010000100001
111101111011101110111
100000000010100000001
101110111110111111101
100010000010000000001
111011011011011011101
100000000010000000001
101110111010111101101
1000000000G0000000001
111111111111111111111